[
  {
    "openingOne": "NONE",
    "openingTwo": "NONE",
    "tiles": [
      [ 14, 14, 14, 14, 14, 14, 14, 14, 14, 14, 14, 14, 14, 14, 14, 14 ],
      [ 14, 14, 14, 14, 14, 14, 14, 14, 14, 14, 14, 14, 14, 14, 14, 14 ],
      [ 14, 14, 14, 14, 14, 14, 14, 14, 14, 14, 14, 14, 14, 14, 14, 14 ],
      [ 14, 14, 14, 14, 14, 14, 14, 14, 14, 14, 14, 14, 14, 14, 14, 14 ],
      [ 14, 14, 14, 14, 14, 14, 14, 14, 14, 14, 14, 14, 14, 14, 14, 14 ],
      [ 14, 14, 14, 14, 14, 14, 14, 14, 14, 14, 14, 14, 14, 14, 14, 14 ],
      [ 14, 14, 14, 14, 14, 14, 14, 14, 14, 14, 14, 14, 14, 14, 14, 14 ],
      [ 14, 14, 14, 14, 14, 14, 14, 14, 14, 14, 14, 14, 14, 14, 14, 14 ],
      [ 14, 14, 14, 14, 14, 14, 14, 14, 14, 14, 14, 14, 14, 14, 14, 14 ],
      [ 14, 14, 14, 14, 14, 14, 14, 14, 14, 14, 14, 14, 14, 14, 14, 14 ],
      [ 14, 14, 14, 14, 14, 14, 14, 14, 14, 14, 14, 14, 14, 14, 14, 14 ],
      [ 14, 14, 14, 14, 14, 14, 14, 14, 14, 14, 14, 14, 14, 14, 14, 14 ],
      [ 14, 14, 14, 14, 14, 14, 14, 14, 14, 14, 14, 14, 14, 14, 14, 14 ],
      [ 14, 14, 14, 14, 14, 14, 14, 14, 14, 14, 14, 14, 14, 14, 14, 14 ],
      [ 14, 14, 14, 14, 14, 14, 14, 14, 14, 14, 14, 14, 14, 14, 14, 14 ],
      [ 14, 14, 14, 14, 14, 14, 14, 14, 14, 14, 14, 14, 14, 14, 14, 14 ]
    ]
  },
  {
    "openingOne": "WEST",
    "openingTwo": "SOUTH",
    "tiles": [
      [ 14, 14, 14, 14, 14, 14, 14, 14, 14, 14, 14, 14, 14, 14, 14, 14 ],
      [ 14, 14, 14, 14, 14, 14, 14, 14, 14, 14, 14, 14, 14, 14, 14, 14 ],
      [ 14, 14, 14, 14, 14, 15, 8, 8, 15, 15, 8, 15, 14, 14, 14, 14 ],
      [ 14, 14, 14, 14, 1, 0, 0, 0, 0, 0, 0, 0, 10, 15, 14, 14 ],
      [ 14, 14, 14, 1, 0, 0, 0, 0, 0, 0, 0, 0, 0, 0, 2, 14 ],
      [ 14, 14, 1, 0, 0, 0, 0, 11, 0, 0, 0, 0, 0, 0, 2, 14 ],
      [ 8, 1, 0, 0, 0, 0, 11, 13, 0, 0, 16, 0, 0, 0, 3, 14 ],
      [ 0, 0, 0, 0, 11, 7, 14, 12, 5, 5, 2, 16, 9, 0, 2, 14 ],
      [ 0, 0, 0, 11, 14, 14, 14, 8, 15, 15, 8, 15, 1, 0, 3, 14 ],
      [ 7, 16, 7, 14, 14, 14, 12, 0, 0, 0, 0, 0, 0, 0, 2, 14 ],
      [ 14, 14, 14, 14, 14, 14, 12, 0, 0, 0, 0, 0, 0, 0, 3, 14 ],
      [ 14, 14, 14, 14, 14, 14, 13, 0, 11, 16, 0, 0, 11, 16, 14, 14 ],
      [ 14, 14, 14, 14, 14, 14, 12, 0, 0, 2, 16, 16, 14, 14, 14, 14 ],
      [ 14, 14, 14, 14, 14, 14, 13, 0, 0, 2, 14, 14, 14, 14, 14, 14 ],
      [ 14, 14, 14, 14, 14, 14, 14, 1, 0, 3, 14, 14, 14, 14, 14, 14 ],
      [ 14, 14, 14, 14, 14, 14, 12, 0, 0, 2, 14, 14, 14, 14, 14, 14 ]
    ]
  },
  {
    "openingOne": "WEST",
    "openingTwo": "SOUTH",
    "tiles": [
      [ 14, 14, 14, 14, 14, 14, 14, 14, 14, 14, 14, 14, 14, 14, 14, 14 ],
      [ 14, 14, 14, 14, 14, 15, 8, 8, 15, 15, 8, 15, 14, 14, 14, 14 ],
      [ 14, 14, 14, 14, 1, 0, 0, 0, 0, 0, 0, 0, 10, 14, 14, 14 ],
      [ 14, 14, 14, 13, 0, 0, 0, 0, 0, 0, 0, 0, 0, 10, 14, 14 ],
      [ 14, 14, 14, 1, 0, 0, 0, 11, 7, 16, 9, 0, 0, 0, 2, 14 ],
      [ 14, 8, 1, 0, 0, 11, 16, 14, 14, 14, 14, 9, 0, 0, 2, 14 ],
      [ 1, 0, 0, 0, 0, 10, 14, 14, 14, 14, 14, 1, 0, 0, 3, 14 ],
      [ 0, 0, 0, 0, 0, 0, 10, 15, 14, 14, 1, 0, 0, 0, 2, 14 ],
      [ 0, 0, 11, 9, 0, 0, 0, 0, 10, 1, 0, 0, 0, 11, 14, 14 ],
      [ 16, 7, 14, 14, 9, 0, 0, 0, 0, 0, 0, 0, 11, 14, 14, 14 ],
      [ 14, 14, 14, 14, 14, 7, 9, 0, 0, 0, 0, 11, 14, 14, 14, 14 ],
      [ 14, 14, 14, 14, 14, 14, 1, 0, 0, 0, 0, 2, 14, 14, 14, 14 ],
      [ 14, 14, 14, 14, 14, 12, 0, 0, 0, 0, 11, 14, 14, 14, 14, 14 ],
      [ 14, 14, 14, 14, 14, 13, 0, 0, 0, 11, 14, 14, 14, 14, 14, 14 ],
      [ 14, 14, 14, 14, 14, 14, 9, 0, 0, 2, 14, 14, 14, 14, 14, 14 ],
      [ 14, 14, 14, 14, 14, 14, 12, 0, 0, 8, 14, 14, 14, 14, 14, 14 ]
    ]
  },
  {
    "openingOne": "WEST",
    "openingTwo": "EAST",
    "tiles": [
      [ 14, 14, 14, 14, 14, 14, 14, 14, 15, 15, 8, 15, 8, 8, 15, 14 ],
      [ 14, 14, 14, 14, 14, 14, 14, 1, 0, 0, 0, 0, 0, 0, 0, 3 ],
      [ 14, 14, 14, 14, 14, 14, 1, 0, 0, 0, 0, 0, 0, 0, 0, 3 ],
      [ 14, 14, 14, 14, 15, 1, 0, 0, 0, 11, 7, 16, 9, 0, 0, 2 ],
      [ 14, 14, 14, 1, 0, 0, 0, 0, 11, 14, 14, 14, 1, 0, 11, 14 ],
      [ 14, 14, 1, 0, 0, 0, 0, 11, 14, 14, 14, 1, 0, 0, 10, 14 ],
      [ 15, 1, 0, 0, 0, 0, 11, 14, 14, 14, 14, 9, 0, 0, 0, 10 ],
      [ 0, 0, 0, 0, 11, 16, 14, 14, 14, 14, 14, 14, 9, 0, 0, 0 ],
      [ 0, 0, 0, 0, 0, 10, 14, 14, 14, 14, 14, 14, 1, 0, 0, 0 ],
      [ 16, 9, 0, 0, 0, 0, 10, 15, 14, 14, 14, 1, 0, 0, 0, 3 ],
      [ 14, 14, 7, 9, 0, 0, 0, 0, 10, 8, 12, 0, 0, 0, 0, 2 ],
      [ 14, 14, 14, 14, 9, 0, 0, 0, 0, 0, 10, 0, 0, 0, 11, 14 ],
      [ 14, 14, 14, 14, 14, 7, 9, 0, 0, 0, 0, 0, 0, 11, 14, 14 ],
      [ 14, 14, 14, 14, 14, 14, 14, 7, 7, 16, 9, 0, 11, 14, 14, 14 ],
      [ 14, 14, 14, 14, 14, 14, 14, 14, 14, 14, 14, 16, 14, 14, 14, 14 ],
      [ 14, 14, 14, 14, 14, 14, 14, 14, 14, 14, 14, 14, 14, 14, 14, 14 ]
    ]
  }
]
